/------------\/------------\
|............||............|
|./--\./---\.||./---\./--\.|
|#|  |.|   |.||.|   |.|  |#|
|.`--'.`---'.`'.`---'.`--'.|
|..........................|
|./--\./\./------\./\./--\.|
|.`--'.||.`--\/--'.||.`--'.|
|......||....||....||......|
`----\.|`--\ || /--'|./----'
     |.|/--' `' `--\|.|     
     |.||          ||.|     
     |.|| /--==--\ ||.|     
-----'.`' |      | `'.`-----
      .   |      |   .      
/------------\/------------\
|............||............|
|./--\./---\.||./---\./--\.|
|#|  |.|   |.||.|   |.|  |#|
|.`--'.`---'.`'.`---'.`--'.|
|..........................|
|./--\./\./------\./\./--\.|
|.`--'.||.`--\/--'.||.`--'.|
|......||....||....||......|
`----\.|`--\ || /--'|./----'
     |.|/--' `' `--\|.|     
     |.||          ||.|     
     |.|| /--==--\ ||.|     
-----'.`' |      | `'.`-----
      .   |      |   .      
