/------------\/------------\/------------\/------------\
|............||............|/------------\/------------\
|./--\./---\.||./---\./--\.|/------------\/------------\
|#|  |.|   |.||.|   |.|  |#|/------------\/------------\
|.`--'.`---'.`'.`---'.`--'.|/------------\/------------\
|..........................|/------------\/------------\
|./--\./\./------\./\./--\.|/------------\/------------\
|.`--'.||.`--\/--'.||.`--'.|/------------\/------------\
|......||....||....||......|/------------\/------------\
`----\.|`--\ || /--'|./----'/------------\/------------\
     |.|/--' `' `--\|.|     /------------\/------------\
     |.||          ||.|     /------------\/------------\
     |.|| /--==--\ ||.|     /------------\/------------\
-----'.`' |      | `'.`-----/------------\/------------\
      .   |      |   .      /------------\/------------\

