                           \/------------\/------------\
                           |/------------\/------------\
                           |/------------\/------------\
|#|  |.|   |.||.|   |.|  |#|/------------\/------------\
|.`--'.`---'.`'.`---'.`--'.|/------------\/------------\
|..........................|                           \
                           |                           \
                           |/------------\/------------\
                           |/------------\/------------\
`----\.|`--\ || /--'|./----'                           \
     |.|/--' `' `--\|.|                                \
     |.||          ||.|                                \
     |.|| /--==--\ ||.|     /------------\/------------\
-----'.`' |      | `'.`-----/------------\/------------\
      .   |      |   .      /------------\/------------\